16 16 15 15 16 16 15 15 15 15 15 15 15 15 15 15 15 15 15 15 15 15 16 16 15 15 16 15 15 15 15 15 15 15 15 15 15 16 15 16 15 16 16 15 15
15 15 16 15 15 16 16 15 16 16 15 15 16 15 15 15 15 15 15 15 15 15 16 15 15 15 16 16 15 15 15 15 16 16 15 15 16 15 15 15 15 15 16 15 15
16 15 15 15 15 15 15 15 15 15 15 15 16 12 12 12 12 12 16 16 15 16 12 12 12 12 12 15 15 16 15 12 12 12 12 12 15 15 15 16 15 15 16 15 15
16 15 15 15 15 15 15 15 15 15 15 15 16 12 12 12 12 12 16 15 15 15 12 12 12 12 12 15 15 15 16 12 12 12 12 12 15 16 15 15 15 15 15 15 15
16 16 15 15 15 15 16 16 15 16 15 15 15 12 12 12 12 12 15 15 16 15 12 12 12 12 12 15 15 16 16 12 12 12 12 12 15 15 15 15 16 15 15 15 15
12 12 12 12 12 12 12 12 12 12 12 12 13 09 09 12 09 09 12 13 13 12 09 09 13 09 09 12 12 13 14 09 09 12 09 09 15 16 15 15 15 16 15 15 15
12 12 12 13 12 12 12 13 09 12 12 12 12 12 12 09 12 13 12 13 12 09 09 12 09 12 13 12 12 12 12 13 09 09 12 12 16 15 16 16 16 15 15 15 15
12 12 12 12 12 12 12 12 12 13 12 12 12 12 12 12 12 12 13 12 12 13 14 12 13 12 12 12 14 12 14 09 12 09 12 14 12 15 15 15 15 15 15 16 15
15 16 16 16 15 16 15 15 15 12 12 12 12 12 12 12 12 12 12 12 12 13 12 12 12 13 12 12 13 12 12 14 13 12 09 12 15 15 15 15 15 15 15 15 16
15 15 15 15 16 16 15 15 16 13 12 12 14 12 12 12 12 14 12 12 12 13 14 12 14 13 12 12 12 12 12 12 13 12 12 12 15 15 15 16 15 15 15 15 15
15 15 15 16 15 16 15 15 15 12 12 12 12 12 12 13 12 12 13 12 12 12 13 13 13 12 12 12 12 12 12 12 14 12 12 12 15 16 15 16 15 15 16 15 15
16 15 16 15 15 15 15 15 16 12 12 12 13 14 12 12 13 12 12 12 12 12 12 12 12 12 14 13 12 12 12 12 13 12 12 12 15 15 15 15 15 16 15 15 15
15 15 15 15 15 15 15 15 15 12 12 12 12 12 12 13 12 12 12 12 13 12 12 13 12 13 13 14 12 14 13 13 12 12 12 13 16 15 15 15 16 15 15 15 15
15 15 15 16 15 15 15 15 15 12 12 12 12 12 13 12 12 12 12 13 12 12 12 13 12 12 09 09 09 09 12 14 12 12 12 12 16 15 16 15 16 15 15 16 15
15 15 15 16 16 15 15 15 15 12 12 12 13 13 12 12 12 12 12 12 12 12 13 12 12 12 09 09 09 09 12 12 12 13 12 12 15 15 15 15 15 15 15 15 16
15 16 15 15 16 16 15 15 15 12 12 12 12 12 12 12 13 12 12 12 12 12 13 12 12 13 09 09 09 09 13 12 13 12 12 12 16 15 16 16 15 15 15 16 15
15 15 15 16 15 15 15 15 15 12 12 12 12 13 12 12 12 12 12 12 14 12 13 12 12 13 13 12 12 12 12 12 12 12 13 12 15 15 15 15 16 15 15 15 15
16 16 15 16 15 15 15 15 15 12 12 12 12 12 12 14 14 12 12 13 12 12 12 12 12 12 12 12 12 12 12 12 12 12 12 12 15 16 15 15 15 15 15 16 16
16 16 16 15 15 15 15 15 16 14 12 12 12 12 12 10 10 10 10 10 10 10 10 10 11 10 10 10 10 10 10 10 10 10 10 10 15 15 10 10 11 10 10 11 10
15 15 15 15 15 15 16 16 15 12 14 12 13 13 10 11 11 10 11 08 08 08 08 11 08 08 08 08 08 10 10 11 10 10 10 10 15 15 10 10 11 10 10 11 10
15 15 15 15 15 16 16 15 15 13 12 13 12 11 10 11 10 10 11 08 08 08 08 11 11 11 08 08 08 11 10 10 11 10 11 10 15 15 10 11 11 10 11 10 10
15 16 15 15 15 16 15 15 15 13 12 10 11 10 11 10 11 10 10 11 10 11 11 10 11 10 11 11 10 10 11 11 10 11 11 10 10 10 11 10 11 11 10 10 10
15 16 15 15 15 15 15 15 16 12 10 11 10 11 10 11 10 11 10 10 10 10 10 11 10 10 11 10 11 10 10 11 11 10 11 10 08 11 10 11 11 10 11 10 10
15 16 15 16 15 16 16 15 16 10 10 10 10 10 10 10 10 10 11 10 10 11 10 10 10 10 10 10 10 10 10 10 10 10 11 10 10 10 10 10 10 10 10 10 10
15 15 15 16 15 15 15 16 15 16 15 15 15 15 15 15 16 15 15 16 15 15 15 15 15 15 15 16 15 15 15 15 15 15 15 16 15 16 16 15 16 15 15 15 15
15 15 15 15 15 15 15 15 15 15 15 15 15 15 15 15 15 16 15 15 15 16 16 16 16 15 15 15 15 16 15 15 16 15 15 15 15 15 15 15 15 16 16 15 16
16 15 15 15 15 15 15 15 15 15 16 16 15 15 15 15 15 16 15 15 15 15 15 15 16 15 16 15 16 15 15 15 16 15 15 15 15 15 15 16 15 15 15 15 16
15 15 16 16 15 15 15 15 15 15 15 15 16 15 15 15 15 16 15 15 15 15 15 16 15 15 15 15 16 16 15 15 15 16 15 15 15 15 15 15 15 15 15 15 16
15 15 15 16 15 16 15 16 15 16 15 16 15 15 16 15 15 15 15 16 15 15 15 15 15 16 15 15 16 15 15 16 15 15 15 16 15 15 16 15 16 15 15 15 15