19 18 19 18 19 18 18 18 19 18 18 18 19 18 18 18 18 18 19 19 19 19 19 18 18 18 19 18 18 18 19 18 18 18 18 18 18 18 18 18 18 18 18 18 18 19 19 18 19 18 18 18 18 18 18 19 19 18 19 18 19 18 18 19 18 18 18 19 19 19 18 18 18 18 19 18 19 18 18 18 18 19 19 18 18 18 19 19 18 19 19 18
19 18 18 18 18 18 18 19 19 18 18 18 18 18 18 18 18 18 18 19 18 18 18 19 18 19 18 18 18 18 18 19 18 19 18 18 19 19 19 18 19 19 18 18 19 19 18 18 18 19 18 18 18 18 18 18 18 18 19 18 19 18 18 18 18 18 18 18 18 19 18 18 18 18 19 18 18 18 18 18 18 18 19 18 18 18 18 19 18 19 19 18
18 18 18 18 19 18 18 18 18 18 18 19 18 18 18 18 18 18 18 18 19 18 19 18 18 19 19 18 18 18 19 19 18 18 18 18 18 18 19 18 19 18 18 18 18 18 18 18 18 18 18 18 18 18 18 18 19 18 19 18 18 18 18 19 18 18 18 18 18 18 18 18 18 18 18 18 19 18 19 18 18 18 18 18 19 18 18 18 19 18 19 18
18 18 19 18 18 18 18 19 18 18 19 18 18 18 18 18 19 18 18 18 19 18 19 18 18 19 18 18 19 18 18 18 18 18 18 18 18 18 18 19 19 19 19 18 18 18 18 19 18 19 18 19 19 18 18 19 18 18 19 18 18 18 18 18 18 18 18 18 18 18 18 18 19 18 18 18 18 18 18 18 19 19 18 19 18 18 19 19 18 18 18 19
19 19 18 19 18 18 18 18 19 18 18 18 19 18 18 18 19 19 18 18 19 19 18 18 18 18 18 19 18 18 18 18 18 19 18 18 18 18 18 19 19 18 18 19 18 18 18 19 18 19 18 19 18 18 19 30 30 30 30 30 30 30 30 30 30 30 30 30 30 30 30 30 30 18 19 18 18 18 18 19 18 18 18 18 19 19 18 18 19 18 18 18
18 18 18 18 18 18 18 19 18 18 18 18 19 18 18 18 18 18 19 18 19 18 18 19 18 18 18 19 18 19 19 18 18 18 18 19 18 18 19 18 18 19 18 18 18 18 19 18 19 19 18 19 18 18 18 30 30 30 30 30 30 30 30 30 30 30 30 30 30 30 30 30 30 19 18 18 18 18 18 18 18 18 19 19 18 18 18 19 18 19 18 18
18 18 18 18 18 18 18 18 18 18 19 18 18 18 19 18 18 18 19 18 18 18 18 19 18 18 18 18 18 18 19 18 18 18 19 18 19 18 18 18 18 18 18 18 18 18 18 19 19 18 18 18 19 19 18 19 30 30 30 30 30 30 30 30 30 30 30 30 30 30 30 30 30 18 18 18 18 18 18 19 18 18 18 18 18 19 19 18 18 19 18 18
18 19 18 18 18 18 18 18 18 18 19 19 19 18 18 18 18 18 18 18 18 18 19 18 19 15 16 15 15 15 18 18 18 19 18 19 18 18 18 18 18 18 18 18 18 18 19 18 19 19 18 18 18 18 18 18 30 30 30 30 30 30 30 30 30 30 30 30 30 30 30 30 30 18 19 18 18 19 18 18 19 18 19 18 19 19 18 18 19 18 19 18
18 18 18 18 18 18 18 19 19 18 18 18 18 18 18 18 19 18 18 18 18 18 18 18 15 15 17 15 15 16 18 18 18 18 19 18 19 19 18 19 18 18 18 18 18 18 18 18 18 18 18 18 19 19 18 19 19 30 30 30 30 30 30 30 30 30 30 30 30 30 18 18 18 18 18 19 19 18 18 18 18 19 18 18 18 18 18 19 18 18 18 18
18 18 18 18 18 19 18 18 18 18 18 19 18 18 19 18 19 18 18 18 18 18 19 18 17 15 15 15 16 15 19 18 18 18 19 19 18 18 18 18 18 19 18 19 18 18 19 18 18 18 18 18 19 18 18 19 18 19 18 18 18 19 18 18 19 18 18 18 18 19 18 18 18 19 18 18 18 18 18 18 18 19 19 18 19 18 18 19 19 18 18 18
18 18 18 18 18 18 18 18 18 18 19 18 18 18 18 18 18 18 18 18 18 18 18 18 15 15 17 15 17 18 18 18 19 19 18 18 18 19 18 18 18 18 18 18 18 19 19 18 18 19 18 18 18 18 18 18 18 18 19 18 18 18 18 18 19 18 18 19 18 18 19 18 18 18 18 19 18 18 18 18 19 19 18 18 18 18 18 18 18 19 19 18
19 19 18 18 18 18 19 18 19 18 18 18 19 18 18 18 19 18 18 18 18 18 18 18 18 19 18 18 19 18 18 18 19 18 18 18 18 18 19 19 19 18 18 18 19 18 18 18 19 19 19 18 18 18 18 18 18 18 18 18 18 18 18 18 18 19 18 18 19 19 19 19 18 18 19 19 18 18 19 18 18 18 18 18 18 19 19 18 19 18 18 18
19 18 18 18 18 18 18 18 18 18 18 19 19 18 18 18 19 18 18 15 17 15 17 15 15 15 15 15 15 15 17 15 15 15 15 15 17 17 17 15 16 15 16 15 18 10 10 10 10 11 10 10 11 10 11 10 11 11 10 11 11 10 10 10 11 10 10 10 10 10 10 11 10 10 10 10 18 18 18 18 18 18 18 18 19 19 18 18 18 19 18 18
18 18 19 19 18 18 18 18 18 18 18 18 18 18 18 18 18 15 17 17 15 15 15 16 15 15 17 15 17 15 15 15 17 16 15 15 17 15 15 15 15 15 15 15 18 10 10 10 10 10 11 10 10 10 10 10 10 10 10 10 10 10 11 11 11 10 11 10 11 11 11 11 10 10 11 10 11 19 19 18 18 18 19 18 19 18 19 19 18 18 18 19
18 18 19 18 18 19 18 18 18 18 18 18 18 18 18 18 16 15 16 15 15 15 17 17 15 15 15 15 15 15 17 15 16 15 17 15 16 16 15 15 16 16 17 15 18 10 11 10 10 10 10 11 10 10 10 10 11 10 11 11 10 10 10 10 11 11 10 11 11 11 11 11 10 10 10 11 10 11 18 19 18 19 18 18 18 18 18 18 18 18 18 18
19 18 19 18 18 18 18 19 18 18 18 18 18 18 18 15 17 17 15 15 15 15 15 15 15 15 16 17 16 15 15 16 16 16 15 16 15 15 15 17 15 17 15 15 18 11 10 10 11 11 11 11 10 11 10 10 10 11 11 10 10 10 11 10 10 11 11 10 11 11 10 10 11 11 10 10 10 10 18 18 19 18 18 18 18 18 18 18 18 19 19 19
18 18 18 18 19 18 18 18 19 19 19 18 18 19 15 17 16 15 15 15 15 16 15 16 15 15 15 15 16 15 15 15 15 15 15 15 15 16 16 17 16 15 15 15 18 10 10 10 11 10 10 10 10 11 10 10 11 11 10 10 11 11 11 10 11 10 10 10 10 11 10 11 10 10 11 10 11 10 11 18 18 18 19 18 18 18 18 18 19 18 18 18
19 18 18 18 18 18 18 19 18 18 19 18 18 15 16 15 16 16 15 16 17 15 15 16 16 15 15 15 17 15 15 15 15 15 15 15 15 15 17 15 16 16 15 16 18 11 11 11 10 11 11 10 10 10 11 10 11 10 10 10 11 10 10 11 10 10 10 10 10 11 10 10 10 10 10 10 11 10 10 18 18 19 19 18 19 18 19 18 18 19 19 18
18 18 18 18 18 19 18 18 18 19 18 18 18 15 15 15 16 15 15 15 15 15 15 15 15 17 15 17 17 15 15 16 15 15 17 15 15 17 15 15 15 16 15 16 18 10 11 10 11 10 10 11 10 11 11 11 10 10 10 10 11 11 10 10 10 11 11 10 11 10 10 11 10 10 10 10 11 11 10 19 18 18 18 19 18 18 19 18 18 18 18 18
18 18 18 18 18 18 18 18 18 18 18 18 18 15 15 15 16 16 15 15 15 16 15 15 16 16 15 17 15 16 15 16 15 16 15 17 15 15 15 15 16 15 17 16 19 11 10 10 10 11 11 11 10 10 11 11 10 10 10 10 10 10 11 10 10 10 10 11 10 10 10 10 10 11 10 10 10 10 10 18 18 18 18 18 18 18 19 18 19 18 19 18
18 19 19 19 18 18 18 18 18 18 19 18 18 17 15 15 15 16 15 15 17 15 15 15 15 15 16 15 15 17 15 17 15 15 16 15 15 16 15 15 17 16 15 15 18 11 10 11 11 11 11 11 10 11 11 10 10 11 10 10 10 10 11 11 11 11 11 10 10 10 10 10 10 11 10 11 10 11 10 18 18 18 18 18 19 18 18 18 18 18 18 18
18 18 18 19 19 19 18 19 19 18 18 18 18 16 15 15 15 15 17 16 17 17 15 15 17 15 17 16 15 16 15 15 17 16 16 15 17 16 15 16 17 15 15 15 19 11 11 11 11 11 10 10 10 10 10 10 10 11 10 10 10 10 11 10 10 10 10 10 10 10 10 10 11 11 10 10 10 10 10 18 18 18 18 19 18 19 19 18 18 18 18 18
18 18 18 18 18 18 18 17 18 18 19 18 18 15 15 15 17 15 15 16 15 15 15 15 17 15 15 17 15 15 15 15 17 15 15 15 15 15 17 15 15 15 15 15 19 11 11 11 10 10 10 11 11 10 10 11 10 10 10 11 10 10 10 10 10 11 11 10 10 10 11 10 10 10 10 10 10 11 10 18 18 18 18 18 19 18 18 18 18 18 18 18
18 19 18 18 19 18 15 17 15 19 18 18 18 15 15 15 15 15 17 17 15 17 15 15 15 17 15 15 17 15 15 16 15 15 15 15 17 15 17 15 15 17 15 15 19 11 11 10 10 11 11 10 11 10 10 10 11 10 10 10 10 11 10 11 10 10 11 10 10 10 10 10 10 10 10 11 10 10 10 19 18 19 19 18 18 18 18 18 18 18 18 18
18 18 19 19 19 15 15 15 15 19 18 18 19 17 16 15 17 15 16 15 15 15 15 15 15 15 15 15 17 17 15 15 15 15 15 15 15 17 16 16 17 15 15 17 18 10 10 10 10 10 11 11 11 10 10 11 10 10 10 11 10 11 10 10 10 10 10 10 11 10 10 11 10 10 10 11 10 11 10 18 18 18 18 18 18 19 18 18 18 19 18 18
18 18 18 18 15 15 16 15 15 15 16 18 19 15 15 15 16 15 15 15 15 15 15 17 16 15 15 16 15 15 17 15 15 15 15 16 15 15 17 15 15 15 00 00 00 00 00 11 11 10 10 11 10 10 10 11 10 10 10 10 11 10 10 10 10 10 10 10 10 10 10 10 11 10 11 10 11 10 10 19 19 18 19 18 18 18 19 18 19 18 19 18
18 19 19 18 16 17 15 15 15 15 15 18 18 16 16 15 15 15 16 17 15 15 16 15 15 15 15 16 15 17 15 15 15 15 15 15 15 16 15 15 15 16 00 00 00 00 00 10 10 11 11 11 10 11 10 11 10 10 11 10 10 11 11 11 11 10 10 10 10 10 10 10 10 10 11 11 10 10 10 18 19 18 19 18 18 18 18 18 18 18 18 18
18 19 19 17 15 15 17 17 15 15 15 18 18 15 17 15 15 15 16 17 15 16 15 15 15 17 15 15 17 15 15 17 15 15 15 15 15 15 15 15 15 15 16 15 18 10 11 10 11 10 10 11 11 10 10 10 11 11 10 10 10 10 10 10 10 10 10 10 10 11 10 11 10 10 11 11 10 10 10 18 18 18 19 18 18 18 18 18 19 18 18 18
18 18 19 18 18 19 15 15 15 15 15 18 18 15 16 17 15 15 17 15 15 17 15 15 16 15 15 16 17 16 17 15 15 15 15 16 15 15 16 15 15 16 15 15 18 10 10 10 10 10 10 10 10 10 10 11 10 10 10 11 11 10 11 11 10 10 10 10 11 11 10 10 11 10 10 10 11 10 10 18 18 18 30 30 30 30 19 19 18 18 18 18
19 18 19 18 18 19 18 15 15 15 15 18 19 15 16 17 15 17 16 17 17 17 16 17 16 15 15 15 16 15 15 15 15 15 15 16 16 15 15 15 15 17 15 15 18 10 10 11 10 10 11 10 11 10 10 10 11 11 10 10 11 11 10 10 11 10 10 10 10 11 10 10 11 10 10 10 11 11 10 18 18 30 30 30 30 30 18 19 18 18 18 18
18 18 18 18 19 19 18 17 15 16 15 19 18 17 16 15 17 15 16 17 17 15 17 17 16 15 15 17 15 17 17 15 15 15 15 15 15 15 15 16 15 15 15 17 18 11 10 10 10 10 10 10 11 10 10 11 10 10 10 10 11 11 10 10 11 10 10 10 10 10 10 10 10 10 10 11 10 11 10 19 18 30 30 30 30 30 18 18 18 18 19 18
18 18 18 18 19 18 18 17 15 16 18 18 18 17 17 15 16 15 17 15 15 15 16 16 16 15 15 15 15 15 15 17 15 15 17 15 17 16 15 17 15 15 15 15 19 10 11 10 10 10 10 11 10 11 11 11 11 10 10 10 10 11 11 10 10 11 10 11 11 10 11 10 11 11 10 10 10 11 10 19 18 30 30 30 30 30 30 18 18 18 19 18
18 18 19 19 18 19 18 18 18 19 19 18 18 16 15 15 16 15 16 15 15 15 15 15 16 15 15 17 15 15 15 15 16 17 15 16 15 15 17 15 15 16 15 17 18 10 11 10 10 10 10 10 11 10 11 10 10 10 10 10 10 10 10 10 10 11 10 10 10 10 10 11 11 11 10 10 10 10 10 18 18 30 30 30 30 30 30 18 18 18 18 19
18 18 18 18 18 18 18 18 19 18 18 18 18 16 15 15 15 17 15 16 15 15 15 16 17 15 15 15 15 15 17 15 15 15 15 15 15 15 15 15 17 15 16 17 18 10 10 11 11 10 10 10 11 10 10 10 10 10 11 10 10 11 10 10 11 11 11 10 11 11 11 10 11 10 10 10 10 10 11 18 18 18 30 30 30 30 18 18 18 19 19 18
18 19 18 18 18 18 18 18 19 18 19 18 18 15 15 17 15 15 15 17 15 16 15 15 15 16 15 15 15 15 15 15 15 15 15 15 15 15 17 15 17 15 15 15 19 10 10 11 10 11 11 10 11 10 10 10 11 11 10 10 10 10 10 11 11 11 11 11 11 10 11 10 11 11 10 10 10 11 11 18 18 18 30 30 30 30 18 19 19 18 18 19
18 18 18 19 18 18 18 18 19 18 19 18 18 17 15 16 15 16 15 15 17 17 16 15 15 17 16 17 15 17 15 15 15 15 17 15 15 15 15 15 16 15 15 15 18 11 11 11 11 10 11 10 10 11 11 11 11 10 10 10 10 11 11 10 10 10 10 10 11 10 11 10 10 11 10 11 10 10 11 19 19 19 30 30 18 18 19 18 18 18 18 18
18 19 18 18 19 19 19 19 19 18 18 19 18 15 15 15 15 17 15 15 15 15 15 16 15 15 15 15 15 15 15 15 17 15 15 15 17 15 15 15 15 15 17 17 18 11 10 11 10 11 11 10 10 10 10 10 10 11 11 10 10 11 11 10 10 10 11 10 11 10 11 10 10 11 10 10 10 11 10 18 18 18 19 30 30 30 18 18 18 18 19 18
18 18 18 18 18 18 18 18 19 18 19 18 18 16 15 15 16 15 15 15 15 15 15 16 16 15 15 15 17 17 15 16 16 15 15 15 15 15 17 17 16 15 16 15 18 10 10 10 10 10 10 11 10 10 10 11 10 10 11 10 10 10 10 10 11 10 11 11 10 11 11 11 10 11 10 10 10 10 10 18 18 18 18 30 30 30 18 18 18 18 18 18
18 18 19 18 19 18 18 18 18 18 19 18 18 16 15 15 15 15 15 15 15 15 15 15 15 15 15 15 17 15 15 16 15 15 17 16 17 15 16 15 17 15 16 15 19 10 10 10 11 10 10 10 10 10 10 11 10 10 10 10 10 10 11 11 10 10 10 10 10 10 10 10 10 10 10 10 10 11 10 18 18 19 19 30 30 18 18 18 18 18 18 18
18 18 18 18 18 18 18 19 18 19 18 18 18 16 15 15 17 15 17 15 15 15 15 17 15 15 15 15 15 17 15 15 16 15 17 15 17 15 15 15 17 15 16 17 19 10 11 11 10 10 10 11 10 11 10 10 11 11 10 10 10 10 10 10 11 10 11 10 11 10 10 10 10 11 11 10 10 10 11 18 18 18 19 30 30 19 18 18 18 18 19 19
18 18 18 18 18 18 18 18 18 18 18 18 19 15 15 15 15 15 16 15 15 15 15 15 15 15 15 16 15 15 17 16 15 15 15 15 15 15 15 17 15 15 17 15 18 10 10 10 10 11 10 11 10 10 10 10 11 10 10 10 10 10 10 10 11 10 11 10 11 11 10 11 10 11 10 10 10 11 11 18 19 18 19 18 18 18 18 18 18 18 18 18
18 18 18 18 18 18 19 18 18 18 19 18 18 17 17 16 15 16 15 15 16 15 16 17 16 15 15 17 15 15 15 15 16 15 16 15 15 15 15 15 17 15 15 15 19 10 10 10 10 11 10 10 10 10 11 10 10 11 10 10 11 10 10 11 11 10 10 10 10 11 10 11 10 10 11 10 10 11 10 18 18 19 18 18 19 18 18 18 18 18 18 19
19 18 19 18 18 18 18 18 18 18 19 18 18 15 15 15 16 17 15 15 16 17 17 17 15 17 15 15 15 15 16 15 15 15 17 15 15 16 15 15 15 15 16 15 18 11 11 10 10 11 11 11 10 10 11 11 11 11 10 11 10 10 10 11 10 10 10 10 10 11 10 10 10 10 10 10 10 10 10 18 19 18 18 18 18 18 18 18 18 18 18 18
19 18 18 18 19 18 18 18 18 19 18 18 18 15 15 15 15 15 15 15 15 16 16 15 15 17 15 15 15 16 15 15 17 15 15 15 15 15 17 17 15 16 15 16 18 19 19 18 18 18 18 18 19 18 18 18 19 18 19 11 10 10 10 10 10 10 10 10 10 11 11 10 10 11 11 11 10 11 10 18 18 19 18 18 18 18 18 19 18 19 18 18
18 18 18 18 18 19 18 19 18 18 19 18 18 18 18 18 18 18 18 18 18 19 19 19 19 18 18 19 18 18 19 18 18 18 18 18 18 18 19 18 18 18 18 18 19 19 18 18 18 18 18 18 18 18 18 18 19 19 18 11 11 10 10 11 10 11 11 10 10 10 10 11 10 10 10 11 10 10 11 19 18 19 19 18 19 18 18 19 18 18 19 18
19 18 18 18 19 18 18 19 19 18 18 18 18 18 18 19 19 19 18 18 19 18 18 18 18 18 18 18 18 18 19 18 18 18 18 18 18 19 18 18 18 19 18 19 19 18 18 19 18 18 18 18 18 19 18 19 19 19 18 11 11 10 11 11 11 10 10 10 11 11 10 10 11 10 11 10 10 10 10 18 18 19 18 18 18 18 18 19 19 18 18 18
18 18 19 19 18 19 19 19 18 18 18 18 18 18 18 18 19 18 18 18 18 18 18 18 18 18 19 19 18 19 18 19 18 18 18 18 18 18 18 18 18 18 19 18 18 18 19 18 19 18 18 19 19 18 18 19 18 18 19 11 10 10 11 11 10 11 11 10 10 11 11 10 11 10 11 11 10 10 10 18 18 18 18 18 19 18 18 18 18 19 18 19
18 18 18 19 18 18 18 19 18 19 18 18 18 19 12 12 12 14 14 14 12 12 12 13 12 14 14 14 12 12 13 12 12 14 14 14 12 12 12 13 13 13 12 12 12 14 12 12 13 12 13 12 14 14 12 12 18 18 18 11 11 11 10 11 11 10 10 11 10 10 10 11 10 10 10 10 10 10 10 18 18 18 18 18 18 18 18 18 18 19 19 18
19 18 18 19 18 18 19 19 18 18 18 19 19 18 13 13 12 12 13 12 14 12 12 13 12 12 12 14 12 12 13 12 14 12 12 14 13 12 12 13 13 14 12 12 12 14 12 13 12 13 12 12 13 14 12 12 18 18 18 10 10 10 10 10 11 10 11 10 11 11 11 10 11 11 10 10 10 10 10 18 18 18 18 18 18 18 18 19 19 18 18 18
19 19 18 18 19 18 18 18 18 18 18 18 18 18 12 12 12 12 12 12 13 12 12 12 12 13 12 12 12 12 14 12 12 12 12 12 12 13 12 12 13 14 12 12 14 14 12 12 12 12 12 12 13 12 14 13 19 18 18 11 11 10 10 10 11 10 10 10 10 10 10 10 10 10 11 11 11 10 10 18 18 18 19 18 19 19 18 19 18 19 18 18
19 19 18 18 18 18 18 19 19 18 18 18 18 18 12 12 13 13 12 12 12 14 12 12 12 12 13 12 12 14 12 12 13 12 12 12 12 14 12 12 12 12 13 12 12 12 12 12 12 14 12 12 13 12 12 12 18 18 18 10 11 10 11 11 11 11 11 11 10 10 10 10 10 10 10 11 11 10 11 18 18 18 18 18 18 18 18 18 18 18 18 18
18 18 18 18 18 18 18 18 18 19 19 19 18 19 12 12 12 13 14 12 12 12 12 13 14 12 12 12 12 12 14 12 12 12 12 12 12 13 13 13 13 12 12 12 12 14 14 12 12 12 14 12 12 12 12 13 18 18 18 11 11 11 10 10 11 11 11 10 11 11 11 11 10 10 11 10 10 10 10 18 18 18 18 18 18 18 18 18 18 19 18 19
18 18 18 18 18 18 18 18 18 18 19 18 18 18 12 12 12 14 12 12 12 12 14 13 14 12 12 14 12 12 12 14 12 13 12 12 12 14 12 14 12 12 12 12 12 12 12 12 12 13 14 12 12 14 12 12 18 18 18 10 10 11 10 10 10 10 10 10 11 11 11 11 11 10 10 10 10 10 10 18 19 18 19 18 19 18 18 18 18 18 19 19
19 18 19 18 18 18 18 18 18 18 18 19 18 18 12 12 13 13 14 12 12 14 12 12 12 13 12 13 13 12 12 12 12 14 12 14 13 12 12 12 12 12 13 14 12 14 12 13 12 14 13 13 12 14 12 13 19 18 18 10 10 10 10 10 11 10 10 11 10 10 10 11 10 11 11 10 10 10 10 18 18 18 19 18 18 19 18 18 19 18 18 18
19 18 18 19 18 19 19 18 18 18 18 18 18 19 12 12 12 12 12 13 12 12 12 12 13 14 12 12 12 12 14 12 12 12 13 14 12 12 12 12 12 12 13 12 14 12 12 12 13 12 12 14 14 12 12 13 18 19 18 10 10 11 11 10 10 11 10 11 10 10 10 11 11 10 10 11 10 11 11 18 18 18 18 19 18 18 18 18 19 18 19 18
18 18 18 18 18 18 18 18 18 18 18 19 19 18 12 14 13 12 12 12 12 13 12 12 12 13 12 12 14 14 12 13 12 14 12 13 12 12 13 12 12 13 12 13 13 12 12 12 12 12 12 12 13 12 13 13 18 18 18 11 11 11 10 11 11 10 10 11 11 11 10 10 10 11 11 10 10 10 11 18 18 18 18 18 18 18 18 19 18 18 18 18
19 18 18 18 18 18 18 18 18 18 19 18 18 18 12 13 12 12 13 12 12 12 12 12 12 12 12 12 12 12 12 12 12 14 12 12 12 13 13 12 13 12 13 14 12 14 14 13 12 12 12 14 13 12 14 12 18 19 18 10 11 10 10 10 10 10 10 11 10 10 10 10 10 10 10 11 10 10 10 18 18 19 19 18 18 19 19 18 19 19 19 18
19 18 18 18 19 18 19 19 18 18 18 19 19 18 12 13 12 12 13 14 13 12 12 12 12 12 12 13 13 12 14 12 14 12 13 12 12 12 12 12 12 13 12 12 13 12 12 12 12 12 14 12 12 13 13 13 18 18 18 11 11 10 10 10 10 10 11 10 11 10 11 00 00 11 10 11 10 11 10 18 18 18 18 19 18 18 19 19 18 18 19 18
19 18 19 18 18 18 18 18 19 18 18 18 18 19 12 12 12 12 12 13 12 12 12 12 12 12 12 12 12 12 14 12 12 12 12 12 14 14 14 12 14 13 12 12 12 12 14 12 12 12 12 13 12 12 13 13 18 18 18 18 18 18 18 19 18 19 19 18 18 19 18 00 00 18 18 18 18 18 18 19 18 18 18 18 19 19 19 18 18 18 18 18
18 18 19 18 18 19 19 18 18 18 18 18 18 19 12 13 14 14 14 12 12 14 13 12 13 12 12 12 13 12 12 12 12 12 12 12 12 14 13 12 12 12 12 12 14 14 12 14 12 12 12 12 12 14 12 13 18 18 18 19 18 18 19 18 18 18 18 19 18 18 18 00 00 19 18 18 19 18 18 18 18 18 18 18 18 18 18 19 18 18 18 18
18 18 18 18 18 19 19 19 19 18 19 18 18 18 12 12 14 13 12 12 13 12 12 13 14 12 12 12 12 12 12 12 12 14 12 13 14 12 12 14 14 12 12 12 13 12 13 12 12 12 12 14 14 12 12 12 14 13 12 13 12 14 13 18 18 18 18 18 19 19 18 00 00 18 19 19 18 18 18 18 18 18 18 19 19 18 18 18 18 18 18 18
18 18 18 19 18 19 18 19 18 18 18 18 19 18 12 12 12 12 12 12 14 14 12 14 12 13 14 12 12 12 12 12 12 12 12 12 13 12 12 12 13 12 12 12 12 14 12 12 12 12 14 12 12 12 12 14 14 12 14 12 12 12 12 18 19 18 18 18 18 19 18 00 00 18 18 18 18 18 18 19 18 18 18 18 19 18 18 18 18 18 18 18
18 18 18 19 19 19 19 19 19 19 19 19 18 19 12 12 12 14 13 12 12 12 13 14 12 14 13 12 12 12 12 12 12 12 12 13 12 12 14 12 12 12 12 12 12 12 12 12 12 12 12 12 12 12 12 14 12 12 12 12 14 14 12 18 18 18 18 18 18 18 18 00 00 18 18 18 18 19 18 18 19 18 18 18 18 18 18 18 18 18 18 18
19 19 18 18 19 19 18 18 18 18 18 18 18 18 14 12 14 14 12 12 12 13 12 12 12 12 12 12 14 12 12 12 12 12 12 12 14 12 14 13 14 13 13 14 12 12 12 14 12 13 13 13 13 12 14 13 13 12 14 12 12 13 14 18 18 19 18 18 18 18 19 00 00 18 18 18 18 19 19 18 18 18 18 18 19 18 19 19 19 18 19 18
18 18 18 18 18 18 18 19 18 18 18 18 18 18 12 14 14 14 12 14 13 12 12 12 12 13 12 12 13 12 12 14 12 12 12 12 12 12 12 12 12 12 12 12 12 12 12 13 12 13 12 12 12 12 12 12 13 12 13 12 12 12 12 18 18 18 18 19 18 18 18 00 00 18 18 18 18 18 19 19 19 18 19 19 19 18 19 18 18 18 18 18
18 18 19 19 18 19 18 18 18 19 18 18 18 18 12 12 12 12 12 12 12 12 12 12 14 12 13 12 12 12 13 12 13 12 14 12 12 14 14 14 12 12 12 14 12 14 12 13 12 12 12 12 12 13 13 14 12 13 12 12 12 12 12 12 14 12 12 12 13 13 14 00 00 14 12 13 18 18 18 19 18 19 18 19 18 18 18 18 18 18 18 18
19 18 18 18 18 19 18 18 19 19 19 18 18 18 12 13 12 12 12 13 12 12 13 12 12 12 12 12 12 12 13 12 12 12 12 12 13 12 12 14 13 12 12 13 12 14 13 14 12 12 14 14 13 12 12 12 14 13 13 12 12 12 14 12 12 12 12 13 13 12 12 12 12 12 12 12 19 18 18 18 18 19 18 18 18 19 18 18 18 18 18 18
18 19 18 19 18 18 19 18 18 19 18 18 19 18 14 12 14 12 14 12 12 13 12 14 13 14 14 14 12 12 12 12 14 13 12 12 14 12 12 14 12 14 12 12 12 12 12 12 13 12 12 12 12 12 14 12 12 12 12 12 14 12 12 12 12 12 12 14 14 12 13 12 12 14 12 12 18 18 19 18 18 18 18 18 18 19 18 18 19 19 18 18
18 18 19 19 19 18 18 18 19 18 18 18 18 18 12 12 12 12 13 14 12 12 12 12 14 14 12 12 12 12 12 12 12 14 12 13 13 13 12 12 12 12 12 12 12 14 12 12 14 12 13 12 12 14 13 13 12 14 12 12 12 12 13 12 12 13 14 12 12 13 13 12 12 12 12 13 18 19 18 18 19 19 18 18 18 18 18 19 18 18 18 18
19 18 18 18 18 18 18 19 19 18 18 18 18 19 12 12 12 12 12 12 12 12 12 12 13 12 12 12 12 13 12 12 12 12 14 14 14 12 12 12 12 13 12 12 13 12 12 13 13 14 14 12 13 14 12 12 12 13 14 14 12 12 12 12 12 14 13 12 13 12 14 12 12 14 12 12 19 18 19 19 19 18 18 19 18 18 18 18 18 18 19 18
19 18 19 18 18 18 18 19 19 18 18 18 18 19 12 12 12 12 12 12 12 12 12 12 14 14 12 14 12 13 13 12 12 12 12 12 12 12 14 12 12 12 12 14 13 12 13 12 12 12 12 13 12 13 12 14 12 12 12 12 12 13 12 12 12 12 12 12 12 13 12 12 14 12 13 14 18 18 19 18 18 18 18 18 18 19 18 19 18 19 19 18
18 19 18 18 18 18 18 18 18 18 18 18 18 18 14 12 12 13 13 12 12 12 14 13 12 12 12 12 12 12 12 12 12 12 12 12 12 13 12 14 13 12 12 12 12 14 12 14 12 12 12 12 13 12 13 13 14 14 12 13 12 12 12 12 12 12 13 13 13 14 13 12 12 14 12 12 18 18 18 19 18 18 18 18 18 19 18 18 18 18 18 19
19 18 19 19 18 18 19 18 18 18 19 18 18 19 12 13 14 12 13 12 14 14 12 12 14 12 12 12 12 14 13 12 13 12 12 12 14 12 12 12 14 14 13 13 12 14 12 12 12 14 12 14 12 13 12 12 13 12 12 14 14 14 12 12 12 12 12 12 12 14 12 12 13 12 14 12 18 18 18 18 18 18 19 18 19 18 18 18 18 19 18 19
18 18 19 18 18 19 18 18 18 19 19 18 19 18 18 12 12 13 12 14 14 13 12 13 12 12 12 12 14 14 12 12 14 13 12 12 12 14 12 12 13 12 13 12 12 12 12 12 13 12 12 12 13 13 12 12 12 12 12 12 12 12 14 14 12 13 14 12 12 12 14 12 13 12 13 14 19 18 18 18 18 18 19 18 19 18 18 18 18 19 19 18
18 19 19 18 18 18 18 19 18 18 18 18 18 18 18 12 12 14 14 12 14 12 12 14 12 13 12 12 14 14 13 14 14 12 12 12 14 12 12 12 12 12 14 12 12 12 12 12 14 12 12 12 12 12 12 12 12 12 12 12 14 12 12 12 12 12 12 13 13 12 12 12 12 12 13 12 19 18 19 18 18 19 18 18 19 18 18 18 18 18 19 18
18 19 19 18 18 18 18 18 18 18 19 19 18 18 19 12 12 12 12 12 12 13 12 14 12 14 12 12 12 12 12 12 12 13 12 14 12 12 12 12 14 12 12 13 12 12 14 14 12 12 12 12 12 13 12 12 12 12 12 13 12 12 12 12 13 12 13 12 12 12 13 12 13 12 12 12 19 19 18 19 19 18 18 18 18 18 18 18 18 19 19 18
18 19 18 18 19 19 18 18 18 18 18 18 19 18 18 18 18 13 12 12 12 14 12 12 12 12 12 14 12 12 14 12 12 14 14 12 12 12 12 12 12 12 14 12 12 12 12 14 12 12 12 12 14 12 12 13 12 12 12 13 12 12 12 12 12 12 12 12 14 12 14 14 12 14 12 18 18 18 18 18 19 18 18 18 18 18 18 18 18 18 18 18
18 18 18 18 19 18 18 18 18 18 19 18 18 18 18 19 19 12 12 12 12 13 13 12 12 13 14 12 12 14 12 12 12 12 12 14 14 12 13 14 12 12 12 12 13 14 14 14 12 14 12 13 12 12 12 12 13 12 13 14 12 12 12 12 14 12 12 14 12 13 12 12 12 13 18 18 19 18 19 19 18 18 19 18 18 18 18 18 18 19 18 19
19 18 19 18 18 18 19 19 18 18 18 19 18 18 18 18 18 18 18 19 12 12 12 12 14 12 12 12 12 12 12 12 14 12 12 12 12 12 12 12 13 12 14 12 12 13 12 12 13 14 12 12 12 12 12 12 12 12 12 12 12 13 13 12 12 14 12 13 14 13 13 12 12 18 18 18 19 18 19 18 18 18 18 18 18 18 19 19 19 18 18 18
19 18 18 19 18 19 18 18 18 18 19 18 18 18 18 18 18 19 18 18 18 18 18 18 18 18 19 18 18 18 18 18 18 18 19 18 19 18 18 18 18 18 18 19 18 18 18 18 18 19 18 18 18 18 18 19 18 18 18 19 18 18 18 18 18 18 19 18 18 18 18 18 18 18 18 19 18 18 19 18 19 18 18 18 18 19 18 18 19 18 18 18
18 18 18 19 18 18 19 19 19 18 18 18 18 18 18 18 18 18 18 19 18 18 19 18 18 18 18 18 18 18 18 18 18 19 19 18 18 19 19 18 19 18 19 19 18 19 18 18 19 18 18 19 19 18 18 18 19 18 18 18 18 18 18 18 18 18 18 18 19 19 19 18 19 19 19 18 18 18 18 18 18 18 19 18 19 18 18 18 18 18 19 19
19 18 19 19 18 18 19 19 19 18 18 19 18 18 19 18 18 18 18 18 18 19 18 18 18 18 19 19 18 18 18 19 14 13 12 12 12 12 12 12 19 19 18 18 18 18 18 19 18 12 14 18 18 18 18 18 18 18 18 12 12 12 14 12 12 12 13 12 13 18 14 12 13 18 18 18 19 18 18 18 19 18 19 18 19 18 18 18 18 18 19 18
19 18 18 18 18 18 19 18 18 19 18 19 18 18 19 18 18 18 19 18 18 14 12 12 12 14 14 12 12 12 12 14 14 14 12 12 12 12 14 12 12 18 18 18 18 18 18 18 19 12 13 12 12 12 12 13 12 14 12 14 12 12 12 12 12 14 14 14 12 12 12 12 12 19 18 19 18 19 18 18 18 19 18 19 18 18 18 18 18 19 18 18
18 18 18 19 19 18 18 19 18 18 18 18 18 18 18 18 19 19 19 18 18 12 14 13 14 12 12 13 12 12 14 14 12 12 12 12 12 12 12 13 18 13 18 18 18 18 18 18 13 12 12 12 12 12 12 12 13 12 14 13 12 13 13 12 13 12 14 14 12 12 14 13 13 19 19 18 19 18 19 18 19 19 18 18 18 18 19 18 18 19 19 18
18 18 19 19 18 18 19 18 18 19 19 19 19 18 19 18 19 18 18 19 18 12 12 13 12 12 13 12 14 12 13 13 12 13 13 12 12 13 12 14 13 12 18 18 19 18 18 18 12 12 12 12 12 12 14 12 12 12 13 13 13 14 14 14 13 12 12 14 13 12 12 18 18 18 18 18 18 18 18 19 19 19 18 19 18 18 18 19 18 18 18 18
18 19 18 18 18 18 19 18 18 18 19 19 18 18 18 18 19 18 18 18 18 13 12 12 13 13 13 14 12 14 12 12 12 14 12 14 13 14 13 12 19 19 19 18 18 19 18 18 19 18 18 18 12 12 13 14 13 12 14 12 12 13 12 13 14 13 12 12 13 12 19 18 18 18 19 18 18 18 19 18 18 19 18 18 19 18 18 18 18 18 18 19
18 18 18 18 18 19 18 19 18 19 18 18 18 18 18 18 18 18 19 18 18 18 18 19 18 18 18 18 19 19 12 12 12 12 12 12 13 12 14 18 18 19 18 18 18 18 19 18 19 19 18 18 18 18 18 13 12 12 18 12 12 12 12 12 12 12 12 12 18 18 18 18 18 18 18 19 18 18 18 19 19 18 19 19 18 19 18 18 18 18 19 18
18 18 19 19 18 18 18 19 19 18 18 19 18 18 18 18 18 18 18 18 18 18 18 18 18 19 18 18 19 18 18 18 14 13 13 14 14 19 18 19 18 18 18 18 18 18 19 19 19 18 18 18 18 19 18 18 19 18 18 14 14 12 12 12 12 12 12 18 18 18 18 18 18 18 19 18 18 19 18 18 18 18 18 18 18 18 18 18 18 19 18 19
18 19 18 18 18 19 18 18 18 19 18 19 19 18 18 18 18 18 18 19 19 18 18 18 19 19 18 18 19 18 18 18 18 18 19 18 18 19 18 18 19 18 18 18 18 18 18 18 19 18 19 18 18 18 18 19 18 18 18 19 18 19 18 19 18 18 18 18 18 19 18 18 18 18 19 18 18 18 19 18 18 18 18 18 18 19 19 18 18 18 18 18
18 18 19 19 18 18 18 18 18 18 18 19 19 18 18 18 18 18 18 18 18 18 18 18 18 18 18 18 19 18 18 18 18 18 19 18 18 19 18 18 18 18 18 18 19 18 19 18 18 18 18 18 18 18 18 18 19 18 18 18 19 19 18 19 18 18 18 18 19 18 18 18 18 18 18 18 19 18 18 19 19 18 18 18 18 18 18 18 18 18 19 18