16 16 15 15 16 16 15 15 15 15 15 15 15 15 15 15 15 15 15 15 15 15 16 16 15 15 16 15 15 15 15 15 15 15 15 15 15 16 15 16 15 16 16 15 15
15 15 16 15 15 16 16 15 16 16 15 15 16 15 15 15 15 15 15 15 15 15 16 15 15 15 16 16 15 15 15 15 16 16 15 15 16 15 15 15 15 15 16 15 15
16 15 15 15 15 15 15 15 15 15 15 15 16 15 15 15 16 15 16 16 15 16 16 15 15 15 15 15 15 16 15 15 15 15 15 16 15 15 15 16 15 15 16 15 15
16 15 15 15 15 15 15 15 15 15 15 15 16 15 15 16 16 15 16 15 15 15 15 15 16 15 16 15 15 15 16 16 15 16 15 15 15 16 15 15 15 15 15 15 15
16 16 15 15 15 15 16 16 15 16 15 15 15 15 15 15 16 15 15 15 16 12 12 12 12 12 12 12 15 16 16 15 15 15 15 16 15 15 15 15 16 15 15 15 15
12 12 12 12 12 12 12 12 12 12 12 12 13 12 12 12 12 12 12 13 13 12 12 12 13 12 12 12 12 13 14 12 12 12 13 12 15 16 15 15 15 16 15 15 15
12 12 12 13 12 12 12 13 09 12 12 12 12 12 12 12 12 13 12 13 12 12 12 12 12 13 13 12 12 12 12 13 12 12 12 12 16 15 16 16 16 15 15 15 15
12 12 12 12 12 12 12 12 12 13 12 12 12 12 12 12 12 12 13 12 12 13 14 12 13 12 12 12 14 12 14 12 12 12 12 14 16 15 15 15 15 15 15 16 15
15 16 16 16 15 16 15 15 15 12 12 12 12 12 12 12 12 12 12 12 12 13 12 12 12 13 12 12 13 12 12 14 13 12 12 12 15 15 15 15 15 15 15 15 16
15 15 15 15 16 16 15 15 16 13 12 12 14 12 12 12 12 14 12 12 12 13 14 12 14 13 12 12 12 12 12 12 13 12 12 12 15 15 15 16 15 15 15 15 15
15 15 15 16 15 16 15 15 15 12 12 12 12 12 12 13 12 12 13 12 12 12 13 13 13 12 12 12 12 12 12 12 14 12 12 12 15 16 15 16 15 15 16 15 15
16 15 16 15 15 15 15 15 16 12 12 12 13 14 12 12 13 12 12 12 12 12 12 12 12 12 14 13 12 12 12 12 13 12 12 12 15 15 15 15 15 16 15 15 15
15 15 15 15 15 15 15 15 15 12 12 12 12 12 12 13 12 12 12 12 13 12 12 13 12 13 13 14 12 14 13 13 12 12 12 13 16 15 15 15 16 15 15 15 15
15 15 15 16 15 15 15 15 15 12 12 12 12 12 13 12 12 12 12 13 12 12 12 13 12 12 12 12 12 12 12 14 12 12 12 12 16 15 16 15 16 15 15 16 15
15 15 15 16 16 15 15 15 15 12 12 12 13 13 12 12 12 12 12 12 12 12 13 12 12 12 12 12 12 12 12 12 12 13 12 12 15 15 15 15 15 15 15 15 16
15 16 15 15 16 16 15 15 15 12 12 12 12 12 12 12 13 12 12 12 12 12 13 12 12 13 13 12 12 12 13 12 13 12 12 12 16 15 16 16 15 15 15 16 15
15 15 15 16 15 15 15 15 15 12 12 12 12 13 12 12 12 12 12 12 14 12 13 12 12 13 13 12 12 12 12 12 12 12 13 12 15 15 15 15 16 15 15 15 15
16 16 15 16 15 15 15 15 15 12 12 12 12 12 12 14 14 12 12 13 12 12 12 12 12 12 12 12 12 12 12 12 12 12 12 12 15 16 15 15 15 15 15 16 16
16 16 16 15 15 15 15 15 16 14 12 12 12 12 12 12 12 12 13 14 12 12 12 12 13 12 14 12 12 12 12 12 13 13 12 12 15 15 16 15 15 15 15 15 15
15 15 15 15 15 15 16 16 15 12 12 12 12 12 13 12 12 12 12 12 12 14 12 12 12 12 12 12 12 12 12 12 12 12 12 12 15 15 15 16 15 15 16 15 16
15 15 15 15 15 16 16 15 15 12 12 12 12 12 12 14 12 12 12 13 12 12 12 13 12 13 12 12 12 13 12 12 14 12 12 12 15 15 15 15 15 15 15 15 15
15 16 15 15 15 16 15 15 15 13 12 12 12 13 12 12 12 12 12 12 12 12 13 12 13 14 12 12 13 12 12 13 12 12 12 12 15 16 16 15 16 15 15 15 15
15 16 15 15 15 15 15 15 16 12 12 12 12 12 12 12 12 12 13 12 14 12 12 12 12 12 12 12 12 12 12 12 12 12 12 13 15 16 16 15 15 16 16 15 15
15 16 15 16 15 16 16 15 16 14 12 12 12 12 12 12 14 12 13 12 14 12 13 12 12 12 12 12 12 12 12 12 12 12 12 12 16 16 16 15 16 15 16 15 15
15 15 15 16 15 15 15 16 15 16 15 15 15 15 15 15 16 15 15 16 15 15 15 15 15 15 15 16 15 15 15 15 15 15 15 16 15 16 16 15 16 15 15 15 15
15 15 15 15 15 15 15 15 15 15 15 15 15 15 15 15 15 16 15 15 15 16 16 16 16 15 15 15 15 16 15 15 16 15 15 15 15 15 15 15 15 16 16 15 16
16 15 15 15 15 15 15 15 15 15 16 16 15 15 15 15 15 16 15 15 15 15 15 15 16 15 16 15 16 15 15 15 16 15 15 15 15 15 15 16 15 15 15 15 16
15 15 16 16 15 15 15 15 15 15 15 15 16 15 15 15 15 16 15 15 15 15 15 16 15 15 15 15 16 16 15 15 15 16 15 15 15 15 15 15 15 15 15 15 16
15 15 15 16 15 16 15 16 15 16 15 16 15 15 16 15 15 15 15 16 15 15 15 15 15 16 15 15 16 15 15 16 15 15 15 16 15 15 16 15 16 15 15 15 15